##########
###A   ###
#        #
#        #
#       B#
#        #
#        #
#   12   #
#        #
##########
