##########
###    B##
#        #
#        #
#        #
#        #
#        #
#   12   #
#A       #
##########
