##########
###     ##
#       B#
#A       #
#        #
#        #
#        #
#   12   #
#        #
##########
