####################
###               ##
#                  #
#                  #
#       #####      #
#B                 #
#####              #
#                  #
#         A        #
#                  #
#               ## #
#                  #
#                  #
#                ###
#                  #
#             ###  #
##                 #
#                  #
####    123     ####
####################
