####################
###A              ##
#                  #
#                 B#
#                  #
#                  #
#                  #
#                  #
#                  #
#                  #
#                  #
#                  #
#                  #
#                  #
#                  #
#                  #
#                  #
#                  #
#####   1234     ###
####################
