####################
###               ##
#                  #
#                  #
#       #####      #
#                  #
#####              #
#                  #
#                  #
#A                 #
#               ## #
#                  #
#                  #
#                ###
#                  #
#             ### B#
##                 #
#                  #
####    123     ####
####################
