####################
###               ##
#                  #
#                  #
#       #####      #
#                  #
#####              #
#                  #
#                  #
#A                 #
#              B## #
#                  #
#                  #
#                ###
#                  #
#             ###  #
##                 #
#                  #
####    12      ####
####################
