####################
###               ##
#                 A#
#                  #
#       #####      #
#                  #
#####              #
#                  #
#                  #
#                B #
#               ## #
#                  #
#                  #
#                ###
#                  #
#             ###  #
##                 #
#                  #
####    123     ####
####################
