####################
##A               ##
#                  #
#              ###B#
#                 ##
#                  #
#                  #
#                  #
#                  #
#                  #
#               ## #
#                  #
#                  #
#                ###
#                  #
#             ###  #
##                 #
#                  #
####    123     ####
####################
