####################
###A              ##
#                  #
#                 B#
##                ##
# ###             ##
##  ## #        #  #
#  ##  #        ## #
##  # ##        #  #
#  ##  #        # ##
##  ##          #  #
#                  #
##  ##   #   #   # #
#  ##              #
##  ##   #   #   # #
#                  #
##                 #
#                  #
#  # # # 12  # # ###
####################
