####################
###A              ##
#                  #
#          B       #
#       #####      #
#                  #
#####              #
#                  #
#                  #
#                  #
#               ## #
#                  #
#                  #
#                ###
#                  #
#             ###  #
##                 #
#                  #
####    12      ####
####################
