####################
###A              ##
#                  #
#                 B#
#                  #
#                  #
#                  #
#                  #
#                  #
#                  #
#                  #
#                  #
#                  #
#                  #
#                  #
#                  #
#                  #
#                  #
#####   12      ####
####################
