##########
###B    ##
#       A#
#        #
#        #
#        #
#        #
#   1    #
#       2#
##########
