##########
###   B ##
#    A  2#
#        #
#        #
#        #
#        #
#        #
#1       #
##########
