##########
###     ##
#       2#
#        #
#        #
#        #
#        #
#        #
#1       #
##########
